あ	亜唖阿愛安我呼吾赤足網亞嗚啞芦宛綾鮎粟英雅会海開挙空厚荒合在朱充彰上浅遭当憧日畔編飽麻明有揚浴會厦堊擧淺當痾蘆鴉
あい	哀愛挨姶鮎会合相優藍會曖逢綾間饗秋乃埃隘
あいだ	間
あいの	藍
あえ	饗和
あお	青粟仰蒼碧
あおい	葵
あか	垢朱赤紅緋明
あかがね	銅
あかつき	暁曉
あかな	茜
あかね	茜
あが	英吾
あがり	上東明揚
あき	暁晃秋淳彰昭晶章聡哲陽璃朗曉亜穐旭紀輝義恭空啓憲顕光幸朱昌祥信審誠詮彬楓飽明亮諒璋顯
あきな	商
あきの	彰
あきら	彰諦晟
あく	悪握惡飽
あくた	芥
あけ	明暁朱珠曙緋曉洙
あけぼの	曙
あげ	挙上揚擧
あこ	赤
あこが	憧
あご	顎
あさ	朝麻旭浅旦淺
あさひ	旭
あざ	字麻浅鮮淺
あざけ	嘲
あざむ	欺
あし	芦脚厚足蘆愛葦肢
あじ	味鯵鰺
あす	朱足飛遊
あず	預
あずけ	預
あずさ	梓
あずま	東
あせ	汗焦
あぜ	畦畔
あそ	麻浅朝遊淺
あぞう	薊
あた	熱辺与與邊
あたい	価値價
あたた	温暖溫
あたま	頭
あたら	新
あだ	仇徒
あっ	悪圧斡壓惡安且厚荒呆
あつ	渥圧貴淳篤敦壓温敬厚宏集充醇暑昌惇熱豊豐暑溫
あつか	扱
あつかい	扱
あて	宛当當
あてら	左
あで	艶
あと	後痕跡歩步
あな	穴孔
あなど	侮侮
あに	兄
あね	姉
あの	穴
あば	暴
あばら	肋
あぶ	虻危蛇
あぶみ	鐙
あぶら	脂油
あぶり	焙
あま	雨奄天尼海甘余餘
あまが	尼
あまの	天
あまり	余餘
あまる	余餘
あみ	編網
あめ	飴雨天
あめの	雨
あめりか	米
あも	天厦
あや	絢綾彩史文礼禮怪危寄彰紋妖綺
あやつ	操
あやま	過誤謝
あゆ	鮎愛歩步
あら	荒新洗粗粕
あらい	洗
あらし	嵐
あらそ	争爭
あらた	改
あららぎ	蘭
あられ	霰
あらわ	現著表著
あり	在有蟻
ある	歩有步
あるじ	主
あれ	荒
あわ	粟泡哀慌淡併沫倂
あわが	粟
あん	安庵暗案杏行按闇鞍塩晏罨莇餡鹽
い	以伊位依偉囲夷委威尉意慰易椅為畏異移維緯胃萎衣違遺医井衛五合指猪肥唯揖圍彙爲衞醫娃葦庵惟亥磯壱稲印院英堰岩忌宜居言浩行斎射炊生逝石煎祖胆鋳入飯妃斐比美氷門癒要稜倚壹已帷徠怡懿渭痍齋稻縊膽菲藺蝟谿鑄韋頤
いい	飯宜猪
いえ	家
いお	庵
いおの	庵
いか	怒
いかずち	雷
いかだ	筏
いかり	碇
いが	毬
いがり	碇
いき	域紀粋息伯粹閾生
いきお	勢
いきどお	憤
いぎりす	英
いく	育郁幾行征生至侑
いくさ	戦戰
いけ	活生池
いけの	池
いこ	鼓憩
いさ	石諌勲功砂勇勳諫
いさぎよ	潔
いさご	砂
いざ	射
いざり	漁
いし	石
いしずえ	礎
いじょう	牛
いず	出厳泉嚴
いずみ	泉
いそ	磯急礒
いそが	忙
いた	板分至傷致潮痛悼
いただ	頂
いただき	頂戴
いたち	鼬
いため	撓
いだ	抱
いち	一壱市壹逸
いちご	苺
いちじる	著著
いちの	櫟檪
いっ	一逸壱溢飯揖壹
いつ	一逸五逸壱溢允乙伍斎慈稜壹齋
いつき	斎齋
いつく	厳嚴慈
いつつ	五
いつわ	偽僞
いづ	厳出泉嚴
いで	出
いと	糸絲綸
いとし	愛
いとな	営營
いど	戸挑
いな	稲否稻苗
いぬ	犬狗戌
いね	稲稻
いの	猪伊井亥稲祈飯悲稻祈
いのしし	猪
いのち	命
いばら	茨荊
いぶし	燻
いぼ	疣
いま	今
いまし	戒
いまわ	忌
いまん	敏
いむ	忌
いも	芋薯妹
いもうと	妹
いや	嫌厭卑否弥卑
いよ	彌
いよう	陽
いら	平
いり	西入煎杁
いる	日入
いれ	入
いろ	色
いろど	彩
いわ	岩磐巌祝祝
いわい	祝
いわし	鰯
いん	囲印咽員因姻引飲淫蔭院陰隠韻音圍隕隱伊允胤什鷹寅慇殷湮鸚
いんの	因
う	右宇烏羽迂雨卯鵜有謗芋雲央恩海飢牛銀愚撃胡劫産受秀熟植織生請太打笛兎菟討頭得韮売布府浮武埋優憂祐凰鬱盂紆賣擊
うい	初
うえ	上植飢
うお	魚
うかが	伺
うかがい	伺
うき	浮
うきの	浮
うぐい	鯏
うぐいす	鴬鶯
うけ	受請
うけたまわ	承
うげ	向
うご	動
うさぎ	兎
うさぎう	兎
うし	牛丑後
うしお	潮
うしな	失
うしゃおし	孝
うしろ	後
うじ	氏路蛆牛寺池
うじゅう	従從
うす	碓臼薄
うすじ	筋
うず	渦水
うずら	鶉
うせい	浩
うそ	嘘噓
うた	唄歌詩吟唱打謡謠
うたい	謡謠
うたが	疑
うち	打内討渕
うっ	打討鬱
うった	訴
うつ	内鬱移映空写打寫
うつく	美
うつくし	美
うつつ	現
うつぼ	靭靱
うつわ	器器
うで	腕
うでっぷ	腕
うと	疎
うとつ	凹
うな	鰻
うなが	促
うなぎ	鰻
うね	畝畦畔
うの	卯鵜府
うば	姥奪
うぶ	産生
うま	旨馬甘午
うまや	厩
うみ	海海臣膿
うみょう	明
うむ	武
うめ	梅楳梅埋
うめい	命
うめん	麺
うや	谷
うやうや	恭
うやま	敬
うら	浦裏恨占卜
うらし	嬉
うらな	占
うらない	占
うらや	羨
うり	売賣瓜
うりゅ	瓜
うる	蔚砂漆潤
うるい	閏
うるう	閏
うるお	潤
うるし	漆
うるち	粳
うるわ	麗
うれ	愁憂
うれし	嬉
うわ	上浮
うん	運雲温銀吽耘蘊溫
うー	烏武
え	絵愛依衣荏餌栄英衛悦央会回壊恵慧江枝重美柄由會壞惠榮繪衞亜右影映永穎頴詠榎押獲喜兄笑植星得飯茂亞穢
えい	叡営影映栄永泳洩瑛英衛詠鋭營榮衞裔嬰曳穎頴延喜慧暎睿翳
えいし	喜
ええ	詠鋭榮
えが	描
えき	易液疫益駅伯役驛浴掖繹腋
えさ	餌
えだ	枝條
えち	越
えっ	越謁閲
えつ	悦謁越閲謁逸咽
えの	榎絵繪
えのき	榎
えび	蛯蝦胡鰕
えびす	夷胡戎
えみ	笑
えら	偉選
えり	襟衿撰
えん	円園宴延怨援沿演炎煙猿縁艶苑遠鉛塩媛淵冤圓焉艷閻鹽緣厭堰奄掩焔燕賢羨嚥婉捐衍涎臙袁豌焰
えんじゅ	槐
えんの	役
お	悪越汚央牡御緒小青男凸尾夫穂面雄郎和惡穗緖郞阿愛浦遠於奥押王黄乙恩穏音下起鬼魚呉皇降桜士治終織臣推生惜折扇帯大淡置苧追渡島忍百負保麻勇邑落朗老嗚奧帶櫻穩飫黃
おい	及生追負老笈
おいの	狼
おう	逢凹央奥往応押旺横欧殴王翁黄皇桜凸凰嘔奧應櫻歐毆謳橫黃粟庵襖鴬鴎鴨仰扇相太鷹淡尾芳邑媼懊枉袍鏖鞅鶯鸚鷗
おうぎ	扇
おうと	凸
おお	王太大欧仰青多覆邑歐鉅
おおかみ	狼
おおぎ	扇
おおぞら	宙
おおとり	鳳
おおやけ	公
おか	岡丘岳侵犯阜冒陸嶽
おが	拝拜
おがみ	拝拜
おき	沖置奥起興奧
おきな	翁
おぎ	荻脇
おぎな	補
おぎゅ	荻
おく	奥億屋憶臆奧後送贈置遅遲贈
おくり	贈
おけ	桶岡置
おこ	興怒
おこし	輿
おこた	怠
おこっ	興
おこな	行
おごそ	厳嚴
おさ	長雄治収修納伯抑收筬
おさか	刑
おさな	幼
おし	押忍鴛教
おしゃ	長
おしょ	忍
おじ	牡
おす	雄
おそ	畏恐教襲遅獺遲
おそれ	虞恐
おだ	穏穩
おち	落乙
おちい	陥陷
おっ	追越億乙
おっく	億
おっと	夫
おつ	乙越
おと	乙音男弟劣
おとうと	弟
おとぎ	弟
おとこ	男
おとし	落
おとしい	陥陷
おとず	訪
おとろ	衰
おど	脅躍踊
おどし	縅
おどり	踊
おどろ	驚
おな	翁女同
おに	鬼
おの	尾
おのおの	各
おのれ	己
おば	姨
おび	帯帶
おびや	脅
おぼ	覚溺覺
おぼえ	覚覺
おぼろ	朧
おみ	臣
おも	主面思重
おもい	思
おもて	表面
おもむ	赴
おもむき	趣
おや	親
おゆ	老
およ	泳及
およぎ	泳
おり	織折芳里
おる	織
おれ	俺折
おろ	卸愚
おろし	卸
おわり	終
おん	園怨苑遠恩温穏音御穩溫隠鬼諺雄隱
おんな	女
か	渦下化仮何価佳加可嘉夏嫁家寡科暇果架歌河火珂禍稼箇花苛荷華菓課嘩貨迦過霞蚊賀葛靴個香鹿神川日假價訶顆禍鰯瓜牡伽禾我雅駕馨掛且栢刈勘換駆薫圭桂欠兼懸枯交庚甲斯飼借狩十書勝壬酢赤掃替貸代鍛鳥徒賭買描風変和呵嗅崋戈變痂窩缺罅翔訛軻鍜驅薰
かあ	母
かい	介会解回塊壊快怪悔懐戒拐改械海灰界皆絵開階貝街飼潰買乖會壞懷楷繪諧悔海穎頴廻恢魁晦芥垣萱甘鍵堺掻養偕喙槐獪疥膾蛔誨誡搔
かいが	鎌
かいこ	蚕蠶
かいな	腕
かえ	換替帰返歸
かえで	楓
かえり	帰顧省歸
かえる	蟇
かお	顔薫香薰
かか	各関係掲抱關揭
かかり	掛係
かが	各利蚊鏡屈香
かがみ	鏡鑑
かがや	輝
かがり	篝
かき	垣柿書蛎蠣
かきの	垣柿
かぎ	鍵鈎限釣鉤
かく	画嚇各拡格核殻獲確穫覚角較郭閣隔革客擴殼畫覺隠劃廓撹岳鶴嶽挌攪擱攫槨隱馘
かくし	隠隱
かくれ	隠隱
かけ	掛欠懸賭武缺
かけはし	梯
かげ	蔭陰影景掛崗
かこ	囲圍栫
かご	籠篭
かさ	笠傘重嵩瘡
かさか	笠
かさね	重
かざ	風桑飾
かざり	飾
かし	樫橿貸柏
かしこ	賢
かしら	頭
かしわ	柏
かじ	梶舵
かじか	鰍
かす	春糟粕和烏
かすみ	霞
かすみの	霞
かず	一数利和數壱葛義憲五主寿収宗千知邦凡万量壽收籌萬
かずら	葛鬘
かせ	稼笠枷
かせぎ	稼
かぜ	風
かぞ	数數
かた	潟型形肩交像片方舘堅県賢固語硬酢尊竪難縣難
かたき	敵
かたち	形貌
かたな	刀
かたば	酢
かたぶき	傾
かたまり	塊
かたむ	傾
かたよ	偏
かたわ	傍
かち	勝徒渇渴
かっ	画各格角閣割喝括活滑葛褐甲合勝畫核隔恰渇刈脚喀恪羯闊渴
かっぷ	冠
かつ	割喝括活渇滑葛褐轄克勝雄喝渴褐且健鹿捷担刮擔蝎闊
かつお	鰹
かつら	葛桂
かづ	和憲
かて	糧
かと	門
かど	角門廉
かな	金叶銀哉奏鉄悲鐵
かなえ	鼎
かなえざ	叶
かなめ	要
かなら	必
かに	蟹
かね	金兼鐘銀矩周鉄包鐵
かねが	鐘
かの	鹿彼賀叶寒
かのう	叶
かはる	陽
かば	樺蒲椛
かび	黴
かぶ	株冠蕪
かぶと	甲兜
かぶら	鏑蕪
かべ	壁
かま	蒲釜鎌窯竃構竈
かまど	竃
かまん	釜
かみ	紙上神髪髮神頭
かみなり	雷
かむ	神
かむら	嘉
かめ	亀龜瓶甁
かも	鴨蒲甘醸神釀
かもの	鴨
かや	茅栢萱柏
かゆ	粥
かよ	雅通
かよい	通
から	殻空唐殼烏韓辛税柄絡涸
からかさ	傘
からす	烏
からだ	体體
からめ	搦
かり	仮刈香借狩假苅雁美
かる	刈苅軽輕
かれ	枯彼
かろ	軽唐輕
かわ	河革川皮渇乾渴
かわら	瓦
かを	夫
かん	感間館官完管巻刊乾冠寒勘勧喚堪姦寛干幹患慣憾換敢柑棺款歓汗漢環甘監看簡緩缶肝艦観貫還鑑閑関陥韓広甲神菅函勸卷廣悍歡燗瞰罐羹觀關陷寬漢神河蒲鎌萱苅侃桓潅竿翰莞諌舘翫咸喊奸宦嵌撼桿檻浣涵灌煥疳癇皖箝緘艱諫鉗鹹
かんが	鑑考
かんざし	簪
かんど	梶
かんの	甲
かんば	樺芳
かんむり	冠
が	果河荷菓峨我牙画芽賀雅餓駕瓦閑子鹿日畫下仮伽嘉家歌珂箇華蚊俄臥蛾蟹鍬合鈴假衙鵞
がい	会貝凱劾外害崖慨概涯蓋街該骸谷會慨槪亥海界階咳碍垣飼買丐孩愾漑礙
がえ	替枝
がえる	蛙
がお	顔
がおか	丘
がき	垣書柿描
がぎ	垣
がく	角学岳楽額顎學嶽愕樂覚逆覺諤
がくし	隠隱
がけ	崖掛
がさ	笠傘嵩
がし	樫貸
がしら	頭
がしわ	柏
がす	粕
がすみ	霞
がすり	絣
がせ	瀬瀨
がた	潟型形方県肩片縣
がたき	敵
がたけ	岳嶽
がたな	刀
がたみ	筐
がたり	語
がだき	滝瀧
がっ	学楽月合勝學樂顎
がつ	月刈勝
がつお	鰹
がに	蟹
がね	金兼鐘鉄鐵
がの	我鹿
がのう	我
がはな	鼻
がま	蒲釜窯竃鎌竈
がまち	框
がみ	紙上神髪髮耳頭
がみね	峰峯
がめ	亀瓶甕甁
がも	蒲鴨
がや	谷萱
がゆ	粥
がら	殻十辛柄殼潟
がらき	楽樂
がらし	嵐
がらす	烏
がり	狩刈苅借
がる	軽輕
がわ	川側皮河革
がわら	瓦
がん	丸含岸玩癌眼岩贋頑顔願元河官漢貫鑑巌雁厳嚴嵌鴈
き	黄企伎危喜器基奇寄岐希幾忌揮机旗既期棋棄機帰毅気汽畿祈季稀紀規記貴起軌輝飢騎鬼亀吉桔己崎樹城生智置姫明木来几毀悸歸氣綺麒龜祈既器黃亜衣嘉蛎嬉徽杵峡矩決公効甲哉斬次消水切善其着聴鎮妃敷聞北箕利亞來卉屓峽效暉杞麾淇煕熹畸癸羈聽藝蠣詭諱跪馗騏驥
きき	聞
きく	菊掬鞠
きさ	私象
きざ	刻兆
きし	岸汀
きしの	岸
きじ	雉
きず	傷築疵
きそ	競
きた	北鍛来來
きたな	汚
きち	吉
きっ	吉喫生切拮亀菊吃桔橘
きつ	吉吃喫橘詰屹
きつね	狐
きな	黄黃
きぬ	衣絹
きぬた	砧
きね	杵
きの	城木
きのえ	甲
きば	牙
きび	黍厳嚴
きほ	穂穗
きみ	王君公紀仁
きも	肝
きゃ	伽華脚可花
きゃが	可
きゃく	却客脚
きゃっ	却客脚
きゅ	久
きゅう	臼厩丘久休及吸宮弓急救朽求泣球究窮級糾給旧九嗅舊仇灸鳩柩糺躬
きゅうら	厳嚴
きょ	去居巨拒拠挙虚許距圭墟據擧遽虛渠鋸景裾倨
きょう	杏享京供侠競共凶協叫境峡強怯恐恭挟教橋況狂狭矯胸脅興郷鏡響饗驚兄経梗香嬌峽挾狹經鄕響俠亨僑兇匡卿喬彊暁敬景韮脇匈嚮夾曉梟疆矜莢跫鋏陜竟驕
きょく	局曲極旭玉棘
きょっ	旭曲極
きよ	輝潔香斎淳浄清精聖雪淨
きよし	清
きら	嫌水明
きり	桐切霧斬
きりゅ	桐霧
きれ	裂
きわ	際究窮極
きわめ	極
きん	京僅勤均巾錦斤琴禁禽筋緊菌襟謹近金今勤謹欣欽衿訓公瑾菫衾饉
ぎ	器岐棋気規起偽儀宜戯技擬欺犠疑祇義議城着木来來僞戲氣犧衣黄伎喜奇机汽紀貴妓蟻誼吉杵樹宣置刀葱几祗羲艤魏黃
ぎく	菊
ぎし	岸
ぎた	北
ぎっ	牛切
ぎつね	狐
ぎぬ	衣絹
ぎみ	君
ぎめ	極
ぎも	肝
ぎゃ	脚
ぎゃく	虐逆
ぎゃっ	逆
ぎゅ	牛
ぎゅう	牛久
ぎょ	漁魚御禦馭
ぎょう	京仰凝暁業形行曉教刑校僥翹蟯
ぎょく	玉曲
ぎら	明
ぎり	桐霧限切
ぎれ	切布
ぎろ	宏
ぎわ	際極
ぎん	金吟銀巾懃齦
く	久宮供九句区矩苦駆庫公功口垢工紅貢授區驅育右雲悔核鬼逆丘救朽汲球倶狗玖躯空繰孔杭国酌食組暮飽来裂篭六來吼國嗇懼柞籠蒻袱悔軀
くい	喰杭咋食
くう	空宮供腔劫
くが	救
くき	茎莖洞柊
くぎ	釘
くぐり	潜潛
くげ	鵠
くさ	種草日臭腐臭
くさか	草
くさり	鎖
くし	串櫛釧
くしざ	串
くじ	櫛籤
くじら	鯨
くす	楠薬藥葛
くすの	楠
くすり	薬藥
くず	葛屑樟楠崩
くずれ	崩
くせ	癖曲
くそ	糞
くだ	管下砕碎
くち	口朽
くちびる	唇
くっ	屈掘倶
くつ	屈掘窟靴忽朽沓
くつがえ	覆
くつの	沓
くつわ	轡
くて	湫
くに	国邦國薫訓柴州洲都圀薰
くぬ	功椚
くぬぎ	椚欅
くの	九此
くば	配
くび	首頚頸
くぼ	窪
くま	熊隈汲曲
くまの	熊
くみ	腫組汲訓酌
くむら	久
くめ	粂
くも	雲曇
くや	悔悔
くら	鞍倉蔵藏暗比峅
くらい	位
くらの	蔵藏
くり	栗繰来來刳
くりや	厨
くりゅ	栗
くる	来狂苦栗來
くるま	車
くれ	呉暮榑
くれない	紅
くろ	黒黑玄畔
くろがね	鉄
くわ	桑加鍬詳
くわだ	企
くわの	桑
くん	勲君薫訓勳燻薰葷
くんね	薫薰
くー	姑
ぐ	久狗具愚弘紅木惧倶玖苦虞郡貢骨颶
ぐい	越杭
ぐう	宮偶遇隅寓
ぐき	茎莖
ぐけ	絎
ぐさ	草種臭
ぐし	串櫛
ぐす	楠
ぐすく	城
ぐすり	薬藥
ぐせ	癖
ぐち	口
ぐつ	靴葛忽
ぐつわ	轡
ぐに	国國
ぐま	熊隈
ぐみ	組汲
ぐも	雲
ぐもり	曇
ぐら	倉蔵藏鞍
ぐらい	位
ぐり	栗群
ぐるま	車
ぐれ	暮榑
ぐろ	黒黑畔
ぐわ	桑
ぐん	群軍郡
け	化仮家華怪気卦懸毛假氣右花芥掛危希稀袈祁圭慶罫計鶏検蹴消笥生付附懈檢癸鷄
けい	佳京競境係傾刑兄啓圭珪型契形径恵慶憩掲携敬景桂渓稽系経継罫茎蛍計詣警軽頚鶏徑惠憬溪經繼莖螢蹊輕頸鷄揭家馨慧繋荊肇勁奎炯瑩瓊痙硅絅綮脛謦谿閨繫
けが	汚
けし	消岸
けす	簀
けず	削
けた	桁
けち	血
けっ	傑欠決潔結血缺穴蹶
けつ	傑欠決潔穴結血訣缺頁楔歇纈闕
けな	穴健
けにえ	贄
けむ	煙
けむり	煙
けもの	獣獸
けら	螻
けわ	険險
けん	絢巻間件倹倦健兼券剣喧圏堅嫌建憲懸拳検権牽犬献研絹県肩見謙賢軒遣鍵険顕験鹸繭儉劍卷圈權檢獻縣腱險顯驗硏鹼鎌乾監捲硯宣劔剱嶮眷虔譴釼騫
げ	下化夏花華牙解外気元毛氣家悔碍間戯卿袈祁慶芸向削蹴殖笥母柳崗戲礙藝餉
げい	芸迎鯨藝慶稽鶏猊
げき	劇撃激隙擊逆戟檄
げた	桁
げち	吉
げっ	月撃激齧擊
げつ	月
げを	雄
げん	間眼喧嫌験元原厳幻弦減源玄現舷言限嚴驗監還拳研賢軒絃諺眩衒訝阮硏
こ	宇黄妓去拠虚個古呼固孤己庫弧戸故枯湖股胡虎誇雇顧鼓香昆仔子児小粉木来來兒據滸琥錮虛黃越箇久居巨許凝桑乎姑狐糊跨鈷乞口垢孝幸弘甲高国込混蚕州焦正請代懲超匂濃肥美彦姫巳娘雄恋篭呱哥國怙戀沽籠蝴蠱蠶詁辜懲
こい	鯉恋戀濃肥
こう	黄河格興仰後交侯候光公功効勾厚口向后喉坑垢好孔孝宏工巧幸広康弘恒慌抗拘控攻晃更杭校梗構江洪浩港溝甲皇硬稿紅紘絞綱耕考肯腔膏航荒行衡講貢購郊酵鉱鋼閤降項香高剛神誠虹日穂耗祐亢哮廣恆效穗肛膠鑛黃神撹較革兜鴨顔亨迎桁絃佼倖巷庚昂糠肱砿鴻肴首衝上正叩亘凰咬哄嚆寇崗恍慷拱攪攷敲曠汞洸淆滉煌狡猴甦皓睾耿肓胛薨蛟覯訌
こうじ	麹糀麴
こうせ	正
こうの	鴻
こうぶり	冠
こうべ	首
こうむ	被
こえ	声肥聲越
こお	幸郡公孝凍
こおり	郡氷凍
こぎ	漕
こく	克刻告国穀酷黒石谷國黑穀鵠剋哭斛
こけ	苔
こげ	焦
ここの	九
こころ	心試
こころざ	志
こころざし	志
こころよ	快
こご	凍
こし	越腰輿漉濾沪
こしが	越
こしき	甑
こす	宇越
こず	梢
こた	応答應
こっ	国骨國滑乞克刻酷黒木黑
こつ	滑骨笏越乞忽惚
こて	犢鐺
こと	異琴言事殊珠
ことば	詞
ことぶき	寿壽
ことわ	断斷
こな	粉
この	近好此木
こば	拒
こび	媚
こぶ	瘤
こぶし	拳
こま	駒狛困細
こまん	駒
こみ	込君
こめ	米
こも	菰薦
こもり	篭籠
こよみ	暦曆
これ	惟是
ころ	頃挙湖殺転擧轉殺
ころも	衣
こわ	声聲壊強怖壞
こん	近金建献港今困墾婚恨懇昆根梱混痕紺魂渾獻権坤昏藍崑棍權焜褌
ご	期古固庫胡五互午呉吾娯後御悟瑚碁語誤護醐子児小兒右河牛居興郷虞湖伍梧后豪砂蚕塵其篭籠茣鄕
ごい	鯉恋戀
ごう	強郷業后降剛号合拷豪傲號鄕河興仰迎巧江劫壕轟神峯囂毫盒
ごえ	越声聲肥
ごおり	郡氷
ごく	極国獄石國圀嶽
ごけ	苔
ごころ	心
ごし	越腰漉
ごせ	越生
ごっ	極
ごと	言事琴毎每
ごの	河
ごま	駒
ごみ	込
ごめ	込米
ごや	越
ごよみ	暦曆
ごろ	頃挙来來擧
ごろも	衣
ごわ	強
ごん	勤金権厳言嚴權勤含欣琴艮魂儼蒟
ごんにゃ	蒟
さ	教狭些佐唆嵯左差査沙砂詐鎖再作紗謝小生早茶狹猿下架覚割寒毅去幸叉瑳裟彩菜坂咲桜皿三山桟刺指舎射蛇酒十浅挿沢知提帆避里冷裂嗟插棧櫻淺渣澤瑣磋覺
さい	再最歳才債催塞妻宰彩採栽済災采砕祭斎細菜裁載際財埼殺雑西斉切騒濟碎齋雜騷齊殺井幸佐哉犀砦紫柴滓猜臍蔡豺賽鰓
さいの	幸
さいわ	幸
さいわい	幸
さえ	冴紗
さえぎ	遮
さお	竿棹
さか	逆坂阪酒積栄咲祥盛榮
さかい	境堺
さかえ	栄榮
さかき	榊
さかずき	杯盃
さかな	魚肴
さかのぼ	遡
さかり	盛
さが	相捜探搜
さき	咲崎先前向埼碕東匂岬嵜
さきがけ	魁
さきよ	聖
さぎ	鷺匂
さく	作削搾昨朔柵窄策索錯冊酢炸咲柞筰醋鑿
さくせ	鑿
さくぼ	窪
さくら	桜櫻
さくらが	桜櫻
さぐ	探
さけ	酒叫鮭
さげ	提
さげす	蔑
さこ	迫
さご	砂
ささ	笹支篠雀朝
ささぎ	陵
さざら	礫
さし	差刺指挿插幸藏
さじ	匙
さす	刺指
さず	教授
さそ	笹誘
さだ	節貞定禎
さち	久幸祥
さっ	幸作昨錯冊刷察札殺早沙咲擦薩颯
さっぷ	寒
さっぽ	札
さつ	冊刷察拶撮擦札殺薩刹殺差咲紮颯
さと	郷聡智敏里鄕覚恵悟仁聖知哲諭理惠聰覺
さな	真眞
さぬ	讃
さね	実實
さのり	紀
さば	鯖裁
さひろ	宏太
さび	寂錆
さぶ	三
さま	様樣
さまた	妨
さみ	網
さむ	寒虫蟲
さむらい	侍
さめ	雨鮫醒
さめが	醒
さや	彩紗鞘清爽莢
さら	更皿
さらし	晒
さる	猿申
さわ	爽早沢澤粟寒障触騒觸騷
さわら	椹
さわん	沢澤
さを	勇
さん	三傘参山惨散桟燦珊産算纂蚕讃賛酸餐參慘棧蠶贊鑽寒撒杉撰簒爨芟讚
ざ	佐左砂坐座挫蔵藏沙三鹿蓙
ざい	宰才歳済細菜剤在材罪財西劑濟哉栽祭斎載際斉齋齊
ざお	竿棹
ざか	坂阪酒
ざかい	境
ざかな	魚
ざき	崎咲埼岬嵜
ざぎ	崎
ざく	冊尺裂
ざくら	桜櫻
ざけ	酒鮭
ざこ	迫
ざさ	笹
ざし	差射
ざっ	雑雜
ざつ	雑雜
ざと	里郷鄕
ざね	実真實眞
ざぶ	三
ざま	様樣
ざむらい	侍
ざめ	覚鮫覺
ざや	鞘
ざら	皿
ざらし	晒
ざる	笊
ざれ	戯戲
ざわ	沢澤
ざん	参山惨産算斬暫残參慘殘岸三桟塹懺棧竄讒
し	仕伺使刺司史嗣四士始姉姿子市師志思指支施旨枝止死氏獅祉私糸紙紫肢脂至視詞詩試誌諮資賜雌飼歯次滋示自信新石弛之茂矢嵐嗜址恣摯祀絲趾齒祉視梓磯塩柿強絞沙仔屍斯侍慈宍執篠芝寿住神仁占染知締尿馬敷閉妹巳吏倭侈嘴壽屎岻幟泗滓溲熾祠翅肆諡輜鴟鵄鹽
しあわ	幸
しい	椎
しいた	虐
しいの	椎
しう	章荘莊
しお	塩汐潮鹽栞
しおが	塩鹽
しおさえ	押
しおの	塩鹽
しか	鹿飾𠮟
しかり	雁然
しき	式識織色敷漉飾鋪
しきの	色
しぎ	鴫
しげ	秀重成繁允栄薫滋臣誠鎮篤蕃茂誉榮譽鎭薰
しこ	重
しし	鹿宍猪
しじみ	蜆
しず	静靜閑賎沈鎮倭賤鎭
しずか	静靜
しずく	滴雫
した	下舌親設慕
したが	従從
したた	滴
しだし	出
しち	七質
しっ	七叱執失嫉湿漆疾濕𠮟櫛悉質尻卓
しっぽ	卓
しつ	叱執失嫉室湿漆疾質濕𠮟七悉膝
しつけ	躾
しづ	静靜
しと	尿
しとみ	蔀
しな	科品稲階級姿稻
しに	死
しね	稲
しの	篠忍
しば	柴芝縛
しぶ	渋澁
しべ	蕊標蘂
しぼ	絞搾柴忍
しぼり	絞
しま	島嶋縞洲嶌
しまり	締
しむ	占
しめ	締示湿濕
しも	下霜
しもの	下
しゃ	叉沙砂舎写射捨赦斜煮社者謝車遮釈奢寫釋社者煮紗借杓庄赤娑洒瀉炙藉赭
しゃく	借尺灼爵酌釈昔石赤釋錯杓錫惜積責折嚼癪芍
しゃこ	積
しゃっ	借尺釈赤釋
しゃん	春
しゅ	主取守手朱殊狩珠種腫趣酒首修衆株鐘須撞侏橦洙繻
しゅう	執囚収周宗就州修愁拾秀秋終繍習臭舟蒐衆襲讐蹴週酬集醜祝袖收羞臭祝繡羽主守洲輯酋夙春焼崇柊鷲燒聚脩蓚褶驟
しゅく	叔夙宿淑祝縮粛肅祝
しゅっ	宿出
しゅつ	出
しゅね	俊
しゅん	俊春瞬竣旬峻舜駿悛浚蠢逡
しゅんせ	浚
しょ	処初所暑庶緒署書諸小處嶼暑署緖諸塩杵曙渚薯墅翔胥蔗蹠鹽
しょう	井従傷償勝匠升召哨商唱奨娼宵将小少尚庄床彰承抄招掌昇昌昭晶松梢沼消渉湘焼焦照症省硝礁祥称章笑粧紹肖蕉衝裳訟証詔詳象賞醤鍾鐘障鞘上姓性政星正清生精聖声青相荘装憧奬將從椒漿燒稱翔聲莊裝證鬆祥涉醬塩咲修縦嘗妾廠捷樟菖蒋鉦征請奘悄殤牀猩璋瘴竦笙縱觴誦逍鹽蔣
しょく	嘱飾拭植殖織職色触食蝕囑觸埴燭卓嗇稷謖贖
しょっ	触食觸燭織職蜀
しょの	餉
しょろ	寄
しょーと	遊
しら	白調
しらべ	調
しり	尻知
しりぞ	退
しる	汁記
しるし	印
しれ	知
しろ	城代白
しろがね	銀
しわ	塩鹽
しを	夫雄
しん	宍伸信侵唇娠寝審心慎振新晋森浸深申疹真神紳臣芯薪親診身辛進針震清請辰津寢愼眞蜃神欣榛秦探呻宸岑斟晨滲瀋箴鍼
しー	煕
じ	餌仕司史嗣士子志氏獅至事似侍児字寺慈持時次滋治爾璽痔磁示耳自辞除神人知地道二之父路兒峙辭茅久牛仔四市師支旨枝死脂詞試而十心進仁甚瀬政智柱夫巳爺林渕瀨
じい	爺
じお	塩鹽
じか	鏡鹿直
じき	食直敷
じく	竺軸竹
じた	舌
じち	質
じっ	実十入實拾勢昵
じつ	実日實十
じな	品
じに	死
じの	師
じば	芝
じま	島嶋縞
じみ	染
じめ	占締
じも	霜
じゃ	砂社者蛇邪舎写謝雀馬奢寫闍麝
じゃく	若寂弱雀昔着尺杓酌石迹
じゃっ	寂弱惹
じゃん	雀政
じゅ	珠趣儒受呪寿授樹需就住従壽從茅守手殊種綬戍聚
じゅう	拾秋終集什住充十従柔汁渋獣縦重銃中頭從澁獸縱鷲絨聚
じゅうと	舅
じゅく	宿塾熟
じゅっ	十熟術述
じゅつ	術述十
じゅん	絢准循旬殉淳準潤盾純巡遵醇順閏俊惇馴隼洵筍詢
じょ	所助叙女序徐除如敍書薯恕抒絮
じょう	井庄祥上丈乗冗剰城場壌嬢常情条浄状畳蒸譲醸錠性成星生盛青静荘定縄乘剩壤孃攘條淨疊繩莊讓釀靜狀牛鎖傷匠昌照醤丞擾杖穣姓政正誠請帖町頂貞鄭門仗滌繞饒醬
じょうの	城
じょく	辱濁縟褥
じょん	正鐘
じら	白
じらみ	虱
じり	尻
じる	汁
じるし	印
じろ	白城
じん	参心神臣進人仁刃塵尋甚尽腎迅陣靭沈參盡靱神深秦針訊珍仞燼衽
す	子主守朱珠寿州洲笥諏須酢数栖素巣數巢右過角吸隅好皇済刷擦酸司捨樹周衆住十助崇嵩据澄寸蘇鋳苧統透陶鈴簾鷲壽濟簀鑄
すい	出吹垂帥推水炊睡粋衰遂酔錐穂穗粹膵醉吸翠杉西誰邃萃
すう	崇数枢數樞秀趨雛芻
すえ	据末居未
すか	砂渚鳥
すが	菅
すがた	姿
すき	隙漉次鋤透梳
すぎ	杉椙生
すく	救宿淑少
すくも	粭
すぐ	直優
すけ	介助輔佑祐右侍典之弼補裕亮
すけっ	助
すげ	菅
すげの	菅
すこ	健少
すご	凄菅
すじ	筋
すす	勧進薦煤勸
すすき	薄芒
すず	鈴鐸涼
すずめ	雀
すずめの	雀
すずり	硯
すそ	裾
すた	廃廢
すっ	寿壽
すて	捨
すで	既既
すな	砂直
すね	脚臑
すの	洲春墨簀
すばる	昴
すべ	滑全
すまし	清
すみ	角隅住純澄炭墨墨寿清速燈壽
すみの	住
すみれ	菫
すめ	皇
すも	宙
すり	摺擦磨擂
する	摺
するど	鋭
すわ	座
すん	駿寸舜澄
すー	徐蘇
ず	子事主酢図逗豆頭圖酸珠寿洲須厨瑞栖巣津辻鶴杜途都鈴壽誦巢
ずい	水随瑞髄隨髓
ずう	数通數
ずえ	末
ずか	好塚
ずき	月
ずく	授竹
ずさ	總
ずし	鮨
ずま	潴
ずまさ	秦
ずみ	済住純澄曇濟角祇積炭墨
ずり	刷摺
ずる	鶴
ずれ	連
ずん	寸
せ	施世瀬勢谷背瀨季競局攻所畝姓聖声西脊責洗旋忍迫頼聲賴
せい	井歳省情世凄制勢姓征性成政整星晴棲正清牲生盛精聖声製西誠誓請逝醒青静斉背婿靖聲靜齊浩犀粛城蒸栖泰惺掣晟睛穽肅臍霽
せき	関汐寂隻席惜戚斥昔析石積籍績脊責赤跡蹟夕晰關堰咳尺碩皙
せこ	迫
せち	節節清
せっ	席石積赤切拙接摂折設窃節説雪攝竊殺瀬隻楔浙瀨
せつ	殺切拙接摂折設窃節説雪哲刹攝泄竊殺節哀屑截渫
せの	勢妹
せば	狭狹
せま	狭迫狹
せみ	蝉蟬
せり	芹
せりょ	芹
せん	仙先千占宣専川戦扇撰栓泉浅洗染潜煎旋穿線繊羨腺船薦詮践選遷銭閃鮮剪專戰殲淺潛箋纖踐錢釧山尖栴煽箭賎銑善僊僭擅氈疝癬盞筌筅簽籤翦蘚譫賤餞饌
せんざ	芹
せんの	仙千
ぜ	世瀬是背瀨所勢前膳
ぜい	情勢税脆説贅盛西誓背筮
ぜき	関關咳跡藉
ぜっ	節絶舌
ぜつ	説絶舌
ぜに	銭錢
ぜま	狭狹
ぜみ	蝉蟬
ぜん	山仙前善漸然全禅繕膳喘涎禪蝉宣染銭蠕錢髯蟬
そ	十噌塑措曽楚狙疎礎祖租粗素組蘇訴阻遡想祖磯沿甲佐宗初染曾疏鼠惣荘卒尊添反湊来來俎咀徂梳疽祚莊蔬詛
そい	添
そう	桑三宗曾曽僧創双叢倉喪壮奏爽層惣想捜掃挿操早曹巣槽燥争痩相窓総綜聡草荘葬蒼藻装走送遭霜騒贈雙壯搜插漱爭總莊裝踪躁騷巢瘦僧層贈粟磯茅繰崇宋匝掻槍漕糟沢爪湊匆叟嗽噪愴滄澤瘡箏筝聰艙搔
そうろう	候
そえ	添副傍
そぎ	祓
そく	塞促側則即息捉束測足速卽燭仄惻熄
そこ	底損
そそ	笹注
そそのか	唆
そだ	育
そっ	側即速卒率卽測
そつ	卒率
そで	袖
そと	外
そな	供備
その	園苑薗其彼
そば	側傍
そま	杣
そむ	背
そめ	染
そら	空徂
そり	剃反橇
そん	存孫尊損村遜松成忖邨
そんじ	松
ぞ	須曾曽祖衣座宗僧
ぞい	添
ぞう	作雑三象草像増憎臓蔵贈造臟藏雜增憎贈僧双曹相雙贓
ぞえ	添副沿
ぞく	束足俗属賊族続屬續粟蔟鏃
ぞこ	底
ぞっ	続續俗属屬
ぞの	園苑薗
ぞむ	望
ぞめ	染初
ぞら	空
ぞん	存尊
た	手他多太汰駄田右蓋堪矯玉建裁食垂炊絶足耐大達谷丹炭断忠天藤立隆咤夛斷
たい	太体堆対耐帯待怠態戴替泰滞胎袋貸退逮隊代台大對帶滯臺體岱腿苔黛鯛帝諦平殆當褪頽颱駘
たいの	鯛
たいら	平
たいらの	平
たえ	妙栲
たお	島倒桃垰
たか	貴敬孝高尚崇鷹隆宇岳毅宜義享喬恭尭昂剛宗嵩尊卓宅竹哲堂武宝峰雄誉亘寶嶽譽
たかの	鷹
たから	宝寶財
たが	互
たがや	耕
たき	滝瀧薫炊焚薰
たきぎ	薪
たきの	建滝瀧
たく	卓宅択拓沢濯琢託度擇澤巧匠啄托鐸坦詫
たくわ	蓄
たぐ	類類
たけ	岳健剛丈茸竹武嶽赳威毅建豪崇嵩壮長孟猛雄壯
たけの	竹炬
たけのこ	筍
たこ	蛸竹
たご	宕
たし	達確足
たじ	丹
たす	助
たず	尋訪
たずさ	携
たた	畳忠疊
たたか	戦闘戰鬭
たたみ	畳疊
ただ	只忠維雅匡正但直貞唯尹
ただし	但
ただよ	漂
たち	達立舘
たちばな	橘
たちばなの	橘
たっ	卓宅達多辰立竜龍磔謫
たっちゅ	塔
たっと	貴尊
たつ	達辰立竜龍起健建樹瀧竪田塔撻燵
たつの	滝瀧辰
たつみ	巽
たて	館建縦盾立縱舘楯帯竪奉帶蓼
たてまつ	奉
たで	蓼
たと	例
たな	棚種
たに	谷渓溪
たね	種胤稙
たの	楽頼樂賴
たは	敬
たば	束刃
たばみ	漿
たび	度旅
たま	球玉賜珠弾霊彈靈圭魂瑞
たまご	卵
たましい	魂
たまの	楡
たまわ	賜
たみ	丹民仁
ため	為溜爲試
たも	保
たよ	便頼賴
たら	荒垂鱈
たり	垂足
たる	垂樽滴熾
たれ	垂
たわむ	戯戲
たわら	俵
たん	堪谷丹単嘆坦担探旦淡炭短端箪綻胆蛋誕鍛壇反單擔膽嘆簞但歎湛耽檀田湯呑曇啖憚憺潭澹痰站譚靼
たんの	淡
たー	重
だ	蛇多太唾堕妥惰打楕陀駄騨田墮驒出舵第達抱佗兌懦拿朶荼躰駝
だい	体戴鯛代台大第醍題弟提梯内妹臺體太岱態乃
だいだい	橙
だいら	平
だか	高鷹
だから	宝寶
だかり	渠
だき	滝瀧抱
だく	沢濁諾澤
だけ	岳竹嶽丈嵩武
だこ	凧蛸
だし	出
だたみ	畳疊
だち	達立裁
だっ	奪脱韃
だつ	奪脱達
だて	館立舘楯点點
だな	棚
だに	谷渓溪
だぬき	狸
だね	種
だま	玉霊靈魂珠弾黙彈默
だら	鱈渡
だらい	盥
だる	怠樽
だれ	垂誰
だわら	俵
だを	男
だん	旦団壇弾断暖檀段男談團彈斷坦淡箪煖疸簞
ち	茅血治質千値知地恥智池痴稚置致遅馳乳盤癡緻遲右喜佐散市持七昌道褫
ちぁん	江
ちい	小
ちいわし	鰯
ちえ	恒恆
ちか	親允央幾規恭近哉史周寸誓力隣
ちから	力
ちが	違
ちぎ	契
ちく	築畜竹筑蓄逐
ちぐせ	癖
ちさ	苣
ちち	秩乳父
ちぢ	縮
ちっ	窒築竹秩蟄
ちつ	秩窒蟄
ちの	茅
ちぶえ	笛
ちゃ	茶爺
ちゃく	嫡着
ちゃっ	着
ちゃん	昌
ちゅ	中
ちゅう	沖厨中仲宙忠抽昼柱注虫衷酎鋳駐冑晝疇蟲鑄註紬肘紐冲稠紂誅
ちゅん	春
ちょ	緒猪著貯緖著樗
ちょう	超町長庁丁重澄兆帖帳弔張彫徴懲挑朝潮牒眺聴腸蝶調諜跳銚頂鳥釣提貼嘲廳聽徵懲凋寵暢脹佻掉晁疔貂趙迢
ちょく	勅捗直敕
ちょっ	直勅敕
ちょる	哲
ちょん	鄭
ちり	塵
ちん	青朕沈珍賃鎮陳灯燈鎭隠慶椿枕珎趾闖隱
ちんた	青
ぢ	血知地
ぢか	近
ぢから	力
ぢゃ	茶
つ	凹津通都美都威越黄詰継厚告次就十尽積接拓着漬釣摘突廿付律葎連恆渫燵盡繼酘突黃
つい	対墜椎追對衝堆槌費
つう	痛通
つえ	杖
つか	束塚塚遣仕使司筑疲柄捕
つかい	使
つかさ	司
つかの	塚
つが	栂
つがい	番
つがね	束
つき	月槻付宮継属築着突附坏屬憑繼舂
つぎ	継次繼亜嗣接二亞
つく	筑作創造佃附
つくえ	机
つくだ	佃
つくり	造作
つくろ	繕
つぐ	亜嗣次亞胤継司従二從繹繼
つぐな	償
つけ	漬付附
つし	對
つじ	辻寿壽
つた	蔦伝傳嶌
つたな	拙
つち	土槌
つちか	培
つつ	筒包
つつが	恙
つつし	謹慎愼謹
つつじ	榴
つつじが	榴
つつみ	堤
つづ	葛続綴廿續
つづき	続續
つづみ	鼓堤
つづら	葛九綴
つづり	綴
つづれ	綴
つと	勤努務勤
つど	集
つな	綱
つなぎ	貫
つなの	綱
つね	経恒常經永雅識典凡庸恆
つねあ	恆
つの	角都募
つば	唾鍔椿
つばき	椿
つばくろ	燕
つばさ	翼
つばめ	燕
つびし	菱
つぶ	粒円潰圓
つぶて	礫
つぶら	円圓
つぼ	坪壷壺
つぼの	坪
つぽ	浦
つま	妻爪嬬
つみ	罪積摘墨
つむ	摘紡
つむぎ	紬
つめ	詰爪冷
つもり	積
つや	艶艷
つゆ	露
つよ	毅強剛豪
つら	面貫連
つらぬ	貫
つり	釣吊
つりゅ	鶴
つる	弦鶴敦釣蔓
つるぎ	剣劍
つれ	連
つを	夫雄
づ	図津圖鶴都
づい	髄髓
づえ	杖
づか	塚司束柄
づかい	遣
づき	月築筑槻突付
づく	附
づくえ	机
づくし	尽盡
づくり	作造
づけ	漬付
づち	槌土鎚
づつ	筒
づつみ	堤
づて	伝傳
づと	苞
づな	綱縄繩
づの	角
づま	妻
づみ	積墨
づめ	詰爪
づもり	積
づら	辛面
づり	刷釣
づる	鶴弦蔓
て	手輝照泰貞帝弟汀天点樋幣豊弖豐點
てい	体袋丁亭低停偵貞呈堤定帝底庭廷弟抵提程締艇訂諦蹄逓邸遞體代綴剃悌挺梯汀碇禎鄭釘鼎叮幀柢牴逞霆
てう	鳥
てき	摘擢敵滴的笛適剔擲狄覿
てっ	徹撤鉄鐵手敵適轍
てつ	綴哲徹撤迭鉄鐵誓轍徳德
てら	寺
てらし	輝
てらす	照
てり	照
てる	輝光照晃昭皓
てれ	寺
てん	典填天展店添纏転顛点殿篆轉點塡顚甜伝傳奠巓恬輾
で	手弟和出豊豐
でい	泥
でき	溺
でこ	凸
でや	亭
でら	寺
でを	夫
でん	典伝殿田電傳澱奠臀鈿
と	外戸十人図青鳥吐塗妬徒斗杜渡登賭途都砥度土頭敏豊門利圖豐都永遠解兜久研採撮止執取勝仁遂説跳津徹兎屠菟鍍砺刀唐等騰洞道寅泊飛富冨閉捕卜本問溶里留櫃礪莵硏
とい	樋
といし	砥
とう	等島棟塔刀頭党稲桐登倒冬凍唐悼投搭東桃盗淘湯涛灯燈当痘祷答筒糖統到董藤討謄豆踏逃透陶騰闘洞道読任納父盜濤當疼稻讀黨鬭禱遠桶十沼逗多塘套蕩瞳百撓滔盪籐鞜韜
とうげ	峠
とうと	貴尊
とお	十遠通
とおり	通
とが	栂咎
とがの	栂
とき	時常刻辰鴇朗
とぎ	伽磨
とく	匿得徳特督篤読讀德玉涜禿牘瀆
とこ	床常砧徳德
とこくさ	臭
とこの	床
ところ	所処處
とし	紀哉歳寿俊智年敏利鋭憲厳淑聡知敦稔怜廉嚴壽
とじ	綴
とせ	歳
とち	栃橡栩
とっ	取鳥特突徳篤独凸吶咄獨德
とっく	徳德
とつ	凹凸突突嫁鳥咄訥
ととの	整調
とど	椴届屆
とどき	届屆
とどけ	届屆
とどけい	届屆
とどこお	滞滯
とどろ	轟驫
とな	唱隣
となり	隣
との	殿外渡砥
とば	殺
とび	飛跳鳶
とびら	扉
とぶ	飛
とぼ	乏
とま	苫
とみ	臣富冨智豊豐
とむら	弔
とむらい	弔
とめ	留
とも	供共知智朝典朋友倫寛具兼公治丈寅曇那伴僚偕舳鞆寬
ともえ	巴
ともし	灯燈
ともな	伴
ともゆ	栄榮
とよ	豊豐樋
とら	虎寅捉
とり	鶏取鳥部鷄工採酉捕
とりの	鷲
とろ	瀞
とん	団東屯沌豚頓富問團同敦遁
ど	戸処渡努度土奴怒頭道處殿堵登途都燈堂読曇門呶弩絨讀駑
どい	樋
どう	倒東等答藤豆働動同堂導洞瞳童胴道銅渡灯燈頭憧撞百恫棠獰瞠
どお	遠
どおり	通
どき	時鬨
どく	得毒独読獨讀徳德
どこ	床
どころ	所処處
どし	年
どっ	独読獨讀毒
どなり	隣
どの	殿
どぶ	溝
どまり	泊
どみ	富冨留
どめ	留止富
ども	供人共塘
どり	鶏取鳥鷄
どろ	泥洞瀞
どん	曇鈍丼貪団灯燈頓呑團緞
どんぶり	丼
な	菜奈那馴南納名阿萎永夏慣泣魚穴今七成長投楠汝乃波苗撫亡無鳴流梁和
ない	内袋乃撫
ないじょ	撫
なえ	苗
なお	尚真眞巨治修直有
なおあ	尚
なか	中仲腹半
なから	半
なが	久良永祥眺長流
ながめ	眺
ながれ	流
なき	泣鳴啼
なぎ	凪薙渚袋柳椥彅
なぐ	殴毆
なぐさ	慰
なげ	嘆嘆
なこ	粉勿
なご	和
なごな	粉
なさ	情
なし	無梨
なしり	後
なぞ	謎
なた	鉈
なだ	灘泪
なっ	納捺
なつ	夏捺懐撫懷
なづる	鶴
なて	梯
なな	七斜
なに	何
なぬ	七
なの	七菜
なべ	鍋辺邊滑邉
なま	生怠
なまず	癜鯰
なまた	俣
なまり	鉛訛
なみ	次南波並浪竝涛列濤
なみだ	涙淚
なみの	浪
なめ	滑嘗
なや	悩惱
なら	習楢並倣雙竝
ならい	習
なり	成也允業形詞慈就伸震勢晴誠斉鳴齊
なる	完成鳴愛育徳德
なれ	馴
なれう	馴
なわ	縄苗繩輪
なわて	畷
なん	何男南軟難納難灘楠喃
に	荷児新仁丹二尼弐日兒貳似爾煮西逃迩姫邇煮
にあき	昭
にい	新
にえ	贄
にお	臭匂臭
におい	香匂
にが	苦
にがみ	神
にぎ	握
にぎり	握
にく	肉辱憎憎
にご	濁
にごり	濁
にし	西螺
にしき	錦
にじ	虹
にじゅう	廿
にじり	躙
にせ	偽僞贋
にた	似
にち	日
にっ	日仁肉
につ	仁
にな	担擔蜷
にの	二似
にぶ	鈍
にゃ	若
にゃく	若蒻
にゃん	娘
にゅ	壬丹二
にゅう	柔乳入敷涌
にょ	女如
にょう	女尿如
にょん	寧
にら	韮
にれ	楡
にわ	庭
にわとり	鶏鷄
にん	人仁任妊忍認刃
ぬ	怒沼脱塗奴抜縫拔
ぬい	縫
ぬか	糠額
ぬき	貫抜拔
ぬく	温貫溫
ぬぐ	拭
ぬぐい	拭
ぬけ	抜拔
ぬさ	幣
ぬし	主
ぬす	盗盜
ぬた	垈
ぬっ	沼
ぬった	沼
ぬの	布
ぬま	沼
ぬり	塗
ぬる	温溫塗溜
ぬれ	濡
ね	音廻根値右恵子寝如禰祢猫峰嶺練寢惠涅鯰練
ねい	寧嚀
ねが	願
ねぎ	葱
ねこ	猫
ねじ	捩
ねず	鼠
ねずみ	鼠
ねた	妬
ねっ	熱根
ねつ	熱捏
ねば	粘
ねぼうき	箒
ねむ	眠
ねら	狙
ねり	練
ねん	縁然年念捻燃粘緣撚稔
ねんご	懇
の	伊暖乃之濃能野飲延於希犬載述乗伸泉蔵廼埜納農布武箆乘箟藏饒
のう	応王嚢悩濃納能脳膿農惱應腦囊翁皇呪直南苗
のうえ	上
のうみ	海
のうら	浦
のえ	永辺邊
のお	尾
のおおきみ	王
のおく	奥奧
のおし	押
のかみ	守
のが	逃
のき	軒木
のきよ	清
のぎの	禾
のくぼ	窪
のくま	熊隈
のくら	倉
のこ	鋸残殘
のこう	小
のこぎり	鋸
のこり	残殘
のこれ	維
のごう	郷鄕
のさと	里
のした	下
のしま	島
のしょう	庄
のしろ	代
のじょう	尉
のす	巣巢
のせ	瀬瀨
のせい	晴
のせき	関關
のぞ	希除望臨
のたかむら	篁
のたき	滝瀧
のだて	館
のち	後
のちゃ	茶
のっ	乗野乘
のつぼ	坪
のつぼね	局
のつら	貫
ので	出
のとう	塔洞
のど	喉
ののし	罵
のはし	嘴觜
のはな	岬
のはま	浜濱
のはや	逸
のはら	原
のはる	原
のば	馬
のふち	渕
のぶ	延修伸信宣夫惟允悦円喜宜啓史将誠暢展登寅房靖庸倫亘圓將迪
のぶま	信
のへ	戸
のべ	延
のぼ	昇上登
のぼう	坊
のぼり	登幟
のま	麻
のまき	巻卷牧
のまた	俣
のみ	飲呑御斐
のみさき	岬
のみち	道
のみなと	湊
のみね	峰
のみや	宮
のみやつこ	造
のめ	妻
のもり	森
のもろ	師
のよ	与與
のり	雅紀規教憲乗則智哲典登徳範法律乘德永寛祈儀宜義矩訓啓敬謙賢糊功孝至式昇慎仁仙宣展伯文稔倫令寬
のる	謙
のろ	呪
のわたし	渡
のん	音呑飲穏暢穩
は	羽歯刃端長把播覇波派破芳葉霸爬齒稲映栄果華垣腫晴生掃早恥張跳貼吐土巴杷伯幡八半繁飯万履麓垪榮玻稻葩萬跛剝
はい	灰俳廃拝排敗杯牌背肺輩配廢拜胚海榛掃早走入盃誹稗佩旆癈
はえ	榛
はか	博墓計諮図測伯謀量圖
はかま	袴
はがね	鋼
はき	吐履
はぎ	萩矧剥剝
はぎゅ	萩
はく	伯剥博拍泊白舶薄迫珀剝柏箔帛搏魄
はぐく	育
はげ	激禿励勵
はこ	函箱運筥
はさ	久挟挾狹
はさま	迫
はざ	廻挟迫挾
はし	橋端箸階走梯梁
はしら	柱
はしり	走
はじ	恥始初
はじきざ	弾
はじめ	始
はす	蓮
はず	外弾筈彈
はずかし	辱
はせ	支
はぜ	櫨
はた	旗機秦端幡畑畠傍
はたけ	畑畠
はたさ	旗
はたら	働
はだ	秦肌膚
はだか	裸
はち	八鉢蜂
はちす	蓮
はちの	鉢
はっ	白八発醗服法發醱初波薄百
はつ	初廿鉢発髪服發髮溌撥觜潑
はと	鳩
はな	花華鼻英端塙放離話
はなし	話噺
はなだ	縹
はなぢ	衂
はなは	甚
はなれ	離
はなわ	塙
はなん	花
はに	埴
はね	羽
はは	母
ははき	箒
はば	幅巾阻
はぶ	省
はま	浜濱
はや	勇逸早速隼駛
はやし	林
はら	原腹払拂
はらい	払拂祓
はらし	晴
はらみ	孕
はり	針張晴貼播梁
はりゅ	針
はる	治春榛晴栄温元原玄浩清暖朝東美敏明靖遥陽榮溫
はれ	晴
はん	坂阪伴判半反帆搬斑板氾汎版犯班畔繁般藩販範煩頒飯凡繁漢榛叛拌攀槃瘢絆范袢
ば	羽歯場刃張庭波婆罵芭馬発葉發齒化左破伯迫蕃芳旛
ばい	灰配倍培媒梅買売賠陪賣梅唄排敗杯輩煤狽黴
ばえ	映蝿蠅
ばかま	袴
ばかり	秤
ばく	博曝漠爆縛莫麦暴幕麥伯白駁寞瀑驀
ばくろ	伯
ばけ	化
ばこ	箱函
ばさみ	鋏
ばし	橋箸
ばしら	柱
ばしり	走
ばす	蓮
ばせ	橋馳
ばた	端幡畑旗畠俣
ばたけ	畑畠
ばち	鉢罰蜂
ばっ	伐罰抜拔麦八末跋麥
ばつ	伐罰抜閥末拔祓跋
ばと	鳩
ばな	花鼻華端
ばなし	話噺咄
ばね	羽
ばば	婆糞
ばま	浜濱
ばみ	喰漿
ばや	早
ばやし	林
ばら	原腹茨服
ばらい	払拂
ばり	治針張鉤
ばる	原春
ばれ	晴
ばん	坂播伴判板版挽晩番盤磐蛮万絆萬蠻晚阪半蕃礬蟠輓鑁
ぱ	羽端播覇波派破霸歯頗叭齒
ぱい	廃拝敗杯肺輩配廢拜俳盃牌佩憊
ぱく	博拍泊白箔舶迫伯薄駁帛魄
ぱだか	裸
ぱち	八
ぱつ	発髪發髮溌撥潑
ぱま	浜濱
ぱら	原腹
ぱり	張
ぱる	春
ぱん	判搬板版犯繁般藩販幡半帆範飯
ひ	火秀灯燈日卑否妃彼悲扉批披比泌疲皮碑秘緋罷肥被誹費避非飛樋氷陽痺祕卑碑引英遠干弾飯匪庇斐簸桧姫不冷丕婢屁彈檜涸砒脾腓蜚裨鄙
ひい	秀贔
ひいら	柊
ひうち	燧
ひえ	稗冷
ひか	光控
ひかえ	控
ひかり	光
ひかる	光
ひが	僻
ひがし	東
ひき	引曳匹挽疋率碾蟇
ひく	曳低
ひげ	髭鬚
ひこ	彦光州
ひこき	彦
ひさ	寿永央久宏尚仙之悠壽
ひざ	膝
ひし	菱
ひしゃく	杓
ひじ	土肘肱
ひじり	聖
ひそ	久潜潛
ひた	常浸直
ひたい	額
ひたし	浸
ひだり	左
ひち	七
ひっ	引匹必筆畢逼
ひつ	泌匹必筆弼櫃謐
ひつじ	羊未
ひつじさる	坤
ひで	英秀茂偉栄康豪榮
ひと	一史士人仁斉等独獨齊
ひとえ	単單
ひとつ	一
ひとみ	瞳
ひとり	独獨
ひな	雛
ひの	桧檜
ひのえ	丙
ひのき	桧檜
ひび	響響
ひびき	響
ひぼ	誹
ひま	暇閑隙
ひめ	姫媛
ひも	紐
ひゃく	百
ひゃっ	百
ひゃん	香
ひや	冷
ひょう	拍俵標氷漂票表評豹兵憑秤瓢平剽雹飄馮
ひよどり	鵯
ひら	平枚開衡
ひる	昼晝蒜蛭
ひるがえ	翻飜
ひれ	鰭
ひろ	寛啓宏弘浩紘仁尋泰大博彦祐裕洋寬英遠央官敬玄公広晃周宗拾十恕祥聖拓典展之弥蓉陽丕廣煕
ひろあ	浩
ひろい	拾
ひろひ	遠
ひわ	鶸
ひん	品浜瀕貧賓頻牝濱賓頻擯殯
び	火孫日比備尾微毘琵眉美鼻媚靡魚妃披斐碑肥樋枇桧傍陽寐檜瀰
びい	贔
びう	為爲
びかえ	控
びかり	光
びき	引曳弾挽疋彈
びこ	彦
びさし	庇
びし	菱
びしお	醤醬
びたい	額
びっ	備
びつ	櫃
びと	人
びな	雛
びゃく	白百闢
びゃっ	白
びゅう	謬
びょう	猫拍描病秒苗平屏屛瓢廟錨鋲兵
びら	平
びる	蒜
びれ	鰭
びろ	広廣
びん	秤備貧敏瓶便敏甁賓愍憫紊閔
ぴ	日否扉比皮秘費祕卑妃庇碑肥被非飛樋毘臂鄙
ぴき	匹
ぴこ	彦
ぴつ	泌筆
ぴゃく	百
ぴょう	氷票表評憑拍標瓢平
ぴょん	平
ぴら	平
ぴる	昼晝
ぴん	品嬪稟萍
ふ	生不付埠夫婦富布府怖扶敷普浮父符腐膚芙譜負賦赴阜附風雰文歩俯孵訃麩步蒲更降拭殖触振深吹船増踏二斑冨斧部伏福噴輔老俘傅巫桴溥腑觸增
ふぃ	菲
ふい	吹
ふう	夫富封風楓諷
ふぇい	菲
ふえ	笛
ふか	深
ふき	吹葺蕗
ふく	伏副復幅服福腹複覆福含吹膨匐袱輻馥
ふくろ	袋
ふけ	吹
ふげ	鳳
ふさ	房塞総總
ふし	節伏節椹
ふじ	藤二
ふせ	臥伏防
ふた	蓋双二雙両兩
ふたお	蓋
ふたた	再
ふだ	札
ふち	縁淵緣渕
ふっ	復福腹払沸拂富風伏副覆弗
ふつ	払沸拂仏佛
ふで	筆
ふと	太
ふところ	懐懷
ふな	舟船舩
ふにゅ	舟
ふね	舟船舩
ふみ	史典踏文邦郁詞章
ふもと	麓
ふゆ	冬
ふり	振降
ふる	古降振震奮
ふれ	触觸
ふん	分噴墳憤奮粉糞紛雰吻扮焚刎忿
ふんどし	褌
ふー	胡
ぶ	生不布府父負侮武舞部風分歩奉無侮步夫婦普浮賦附撫蕪仏穂峰峯佛憮穗誣麩
ぶう	封
ぶえ	笛
ぶか	深
ぶき	吹葺噴
ぶく	伏福
ぶくろ	袋
ぶさ	房
ぶし	節伏
ぶす	毒
ぶすき	宿
ぶすま	衾
ぶせ	臥伏
ぶせり	伏
ぶた	豚蓋二
ぶち	縁淵渕緣
ぶっ	仏物佛
ぶつ	仏物佛忽
ぶと	太
ぶところ	懐懷
ぶね	舟船槽
ぶまさ	昌
ぶみ	文
ぶり	振風
ぶん	分文聞
ぷ	釜付婦布府父符譜賦否夫富斧腐膚附鮒峰腑麩
ぷう	封風
ぷく	伏復幅服腹福複覆
ぷん	粉吻憤奮糞紛
へ	兵辺邊経減戸平閉屁經舳
へい	病丙併兵塀幣平弊柄並蔽閉陛餅竝聘餠倂塀瓶屏斃屛甁
へき	壁癖碧璧僻又劈辟
へだ	隔
へび	蛇
へり	縁緣
へん	偏変片篇編辺返遍扁變貶邊邉
べ	戸倍瓶部兵米辺邊邉甁頭弁辯
べい	平米餅塀
べき	壁冪
べち	淵
べっ	別戸瞥蔑鼈
べつ	別蔑瞥
べに	紅朱
べの	倍
べら	平
べん	便勉娩弁鞭辨瓣辯勉偏眄辮駢
ぺ	北
ぺい	病併兵平蔽閉北倂餅
ぺき	壁癖碧璧
ぺん	平変片編辺變邊篇遍
ほ	火帆布保舗捕歩補穂法哺穗步浦蒲干掘湖胡侯秀彫武鋪圃甫輔呆宝峰褒豊欲匍埔堡寶襃豐鎬
ほい	焙
ほう	封倣俸包呆報奉宝峰崩庖抱放方法泡砲縫胞芳蓬蜂褒訪豊邦飽鳳防北咆寶疱舫襃豐喰胡祝棚判捧朋萌鋒鵬傍房朴幇彭抛硼繃鉋鮑
ほうき	箒
ほうの	朴
ほうむ	葬
ほお	頰頬
ほか	外他
ほが	朗朗
ほき	洞
ほぎ	祝
ほく	北
ほこ	矛架誇鉾
ほころ	綻
ほし	干星乾
ほず	穂穗
ほそ	細
ほたる	蛍螢
ほたるが	蛍螢
ほっ	発法北堀發星払欲拂
ほつ	発發
ほづ	秀
ほとけ	仏佛
ほど	程
ほどこ	施
ほね	骨
ほのお	炎
ほぼ	粗
ほま	誉譽
ほら	洞
ほらが	洞
ほり	堀掘濠彫
ほろ	幌滅
ほん	香反奔本翻飜叛誉譽
ぼ	牡保募墓慕暮母簿菩模応圃歩穂戊褒鳳帽姆應拇穗襃步
ぼう	保抱方法胞訪乏亡傍剖坊妨帽忘忙房暴望某棒冒紡肪膨謀貌貿防妄榜謗茅包呆奉宝峰吠頬厖寶旁眸芒茫蒡鋩頰
ぼうき	箒
ぼうの	坊
ぼえ	吠
ぼく	北僕墨撲朴牧睦木目墨卜穆
ぼこ	鉾凹
ぼこり	埃
ぼし	干星
ぼそ	細
ぼたん	釦
ぼっ	坊勃没墨牧渤
ぼつ	勃没歿
ぼとけ	仏佛
ぼね	骨
ぼまい	舞
ぼら	洞
ぼり	彫堀濠
ぼれ	耄
ぼろ	幌
ぼん	煩本凡盆梵犯
ぽ	保舗歩步畝婆甫補穂宝哺寶穗
ぽう	保俸包報宝峰放方法泡烹砲邦寶封奉胞豊鋒鳳炮豐
ぽく	北袱
ぽろ	幌
ぽん	先本奔
ま	間丸松真馬美摩磨魔麻万満目麗滿眞茉莉萬愛雅巻曲熊交黒混士畳慎正増孫待幡負舞又未卷愼疊增黑
まい	舞米牧埋妹昧枚毎邁每参売迷參賣
まえ	前
まか	任
まかな	賄
まが	曲勾
まがき	籬
まがり	鈎曲
まき	巻蒔牧槙卷槇撒填塡
まきの	牧
まぎ	紛
まく	幕膜
まくら	枕
まくらの	枕
まげ	髷
まこ	誠
まこと	誠
まご	孫
まさ	雅匡公将昌真政正誠直芳優理和將允栄祇賢元宗充順勝晶慎仁征聖斉善泰柾明祐倭愼榮眞齊
まし	益増增猿
まじ	交
ます	益升舛増桝增賢政鱒祐枡
まず	貧
また	股俣又岐全亦
またた	瞬
まだら	斑班
まち	街待町都
まっ	真抹末眞茨松摩
まった	全
まつ	雅松抹末黒祭沫秣茉黑
まつも	黒黑
まつり	祭
まつりごと	政
まと	的本
まど	窓円惑圓
まどの	円圓
まな	愛眞学真俎學
まなこ	眼
まぬか	免免
まね	招
まの	馬
まぶた	瞼
まぼろし	幻
まま	継飯侭儘繼
まみ	狸
まめ	豆
まも	守
まもり	守
まや	厩
まゆ	眉繭誠
まよ	迷
まよい	迷
まり	丸鞠宣余毬餘
まる	丸円圓
まれ	希
まろ	麿
まわ	回周
まわし	廻
まわり	廻
まを	緒緖
まん	幡万慢満漫蔓曼滿萬饅鰻真馬敏茂幔懣眞瞞鬘
まー	麻
み	海観現己御三実深身壬水眉美味未魅巳蜜務弥實觀位芥幹鏡見光子視爾耳珠充臣診瑞聖績泉都妃微満箕民薬已彌惠滿漿藥
みうり	賣
みえ	恵惠
みか	甕
みが	磨
みがき	磨
みき	幹樹
みぎ	右
みくじ	籤
みことのり	詔
みさ	操
みさお	操
みさき	岬
みささぎ	陵
みじ	惨慘
みじか	短
みす	簾
みず	水瑞
みずうみ	湖
みずか	自
みせ	店
みぞ	溝
みだ	淫乱亂
みだれ	乱亂
みち	信通道路紀径充達暢典満弥裕庸理陸倫徑滿迪
みちび	導
みっ	密三
みつ	光三充満密蜜滿允盈晃貢実臣水暢實肆
みつぎ	貢
みづ	瑞
みと	認
みとめ	認
みどり	緑綠翠
みな	皆水南
みなと	港湊
みなみ	南
みなもと	源
みなもとの	源
みにく	醜
みね	峰峯嶺岑
みの	箕耳実蓑實簑
みのり	稔
みみ	耳
みゃく	脈
みや	宮
みやこ	都都
みやこの	都
みゆき	幸
みょう	苗妙冥名命明茗猫
みわ	神
みん	民眠明三水
む	虫浮武謀務夢無牟矛霧六蟲院群向珠蒸撫望睦鵡
むい	六
むか	向迎
むかい	向
むかえ	迎
むかし	昔
むき	向
むぎ	麦麥
むく	向報椋
むくの	椋
むぐら	葎
むけ	向
むこ	婿聟
むこう	向
むさぼ	貪
むし	虫蟲蒸
むしろ	筵
むじ	芝
むじな	狸
むす	結
むすび	結
むすめ	娘
むずか	難難
むだ	徒
むっ	六
むつ	睦六
むな	胸宗棟
むね	胸旨宗棟義
むひょん	賢
むよん	蓮
むら	群村叢邑邨
むらさき	紫
むりだけ	嶽
むろ	室
め	芽雌女米目眼妻召瞳馬梅姫布明銘牝滅免
めい	冥名命明盟迷銘鳴瞑梅茗
めいの	姪
めき	笑
めくら	盲
めぐ	芽恵巡惠
めぐり	廻
めし	召飯
めす	雌
めずら	珍
めっ	滅
めつ	滅
めん	明免綿面麺免麵妻雌棉緬
も	最真喪藻宙美文母面模茂毛門眞右雲持若守裳盛燃馬百望妹摸漏麼
もい	萌門
もう	亡望妄毛猛盲網耗蒙詣申設孟朦莽
もうし	申
もうで	詣
もえ	萌燃
もく	牧木黙目默杢沐
もぐ	潜潛
もち	持望勿餅餠茂用黐
もっ	木牧没黙目勿默
もっけ	牧
もっと	最
もっぱ	専專
もつ	物没
もて	茂
もてあそ	弄
もと	下基元資本幹求許源玄宗誠素智
もとい	基
もど	戻戾
もどし	戻戾
もどり	戻
もの	者物者桃茂
もみ	籾樅
もも	桃百股腿
もや	靄
もよお	催
もよおし	催
もり	守森盛敬護杜茂
もろ	諸師室両兩萬
もん	文聞問悶紋門衛衞
や	屋家哉谷八也冶夜爺耶野弥矢彌綾悦雅岩魚爾辞舎邪焼箭痩亭日病薬柳陽養椰燒藥辭瘦
やい	焼燒柳
やお	八
やかた	館
やき	焼燒咲
やぎ	柳焼燒
やぎゅ	柳
やく	疫益厄役約薬訳躍藥譯扼軛
やぐら	櫓
やけ	焼宅燒
やさ	易優
やしな	養
やしろ	社社
やじ	雅
やす	恭康泰保靖裕和安易育嘉休妥徳寧輔庸綏雍德
やすみ	休
やすん	息
やず	和
やち	萢
やっ	厄約薬藥八躍
やっこ	奴
やつ	八奴
やと	雇
やとい	雇
やど	宿
やどり	宿
やな	柳柵棚梁簗
やない	柳
やなぎ	柳
やに	脂谷
やぶ	破敗薮藪
やま	山日
やまい	病
やまず	斗
やまと	倭
やみ	闇
やむ	飲
やり	遣槍鎗鑓
やわ	柔軟和
やん	賢壌陽壤
やんす	樹
やんほ	鎬
ゆ	湯愉油癒諭輸唯優友悠有柚由祐裕遊夕喩宇温弓結幸弘行逝佑勇憂涌揺搖瑜臾諛溫
ゆい	遺結唯由維
ゆう	右結佑優勇友幽悠憂有湧猶由祐裕誘遊郵雄融夕郁泣湯又尤柳宥柚涌猷邑侑游
ゆえ	故
ゆか	床弘
ゆき	介幸行志雪之由維紀恭敬潔元孝至順章征千透如門于侑靫
ゆく	行
ゆす	梼檮
ゆず	譲柚讓
ゆずり	譲棡讓
ゆた	豊豐
ゆたか	豊豐
ゆだ	委
ゆの	湯柚
ゆび	指
ゆみ	弓弦
ゆめ	夢
ゆり	梨里閖
ゆる	緩許万萬
ゆん	弓俊
よ	四世代夜予余与誉預豫與譽餘依因詠榎寄吉啓呼寿宵酔善読八百米芳輿良壽讀醉饒
よい	宵酔良醉
よう	腰祥鷹八傭幼妖容庸揚揺擁曜楊様洋溶用窯羊葉蓉要謡踊陽養拗搖樣瘍謠熔耀遥沃夭榕燿瑶瓔痒膺邀瑤
よく	抑欲沃浴翌翼慾弋
よけ	除
よこ	横橫
よご	汚
よし	佳嘉喜紀儀義吉慶好克次昌祥善美芳由良和愛芦允栄益悦賀宜誼欣啓圭恵敬賢功孔孝幸香剛斎至慈寿秀淑純順勝仁正斉宣泰男忠禎徳能睦靖礼壽惠榮齋禮脩葭蘆齊德
よしも	謙
よせ	寄
よそお	装裝
よっ	欲四浴
よつ	四
よど	淀
よな	米
よね	米
よば	呼
よび	呼
よぶ	呼
よみ	読讀詠
よめ	嫁
よもぎ	蓬
よゆ	洋
より	寄頼賴依委因賀拠順米緑和據綠
よる	夜
よろ	寄
よろい	鎧
よろこ	喜
よろず	万萬
よわ	弱
よん	四英
よんすう	秀
ら	楽等羅裸良拉樂浦十彰晶税倉螺蘭浪篭籠薇邏騾
らい	来莱頼雷礼來禮賴萊徠癩磊籟
らく	楽洛絡落酪樂烙格
らち	埒埓
らっ	楽落樂喇辣
らっきょ	辣
らつ	辣剌埒埓
らの	蔵藏
らら	晶
らん	乱卵欄濫藍蘭覧亂欒瀾爛覽鸞欄嵐巒懶攬籃纜襴
らー	辣
り	利吏履梨理璃痢裏里離罹莉寄降取垂切乃伐美李裡林鈴俚悧詈
りぃ	里
りき	力
りく	陸戮六
りご	篭籠
りそ	磯
りち	律
りっ	栗立陸律六
りつ	律率立慄栗葎
りほ	庵
りゃお	遼
りゃく	略掠暦曆
りゃっ	略
りゅう	柳立劉流琉留硫粒隆竜龍隆笠滝瀧溜旒榴瘤
りょ	侶慮旅虜虜呂膂
りょう	漁竜龍了亮僚両凌寮料梁涼猟療瞭稜糧良遼量陵領霊兩獵繚輛輌靈綾永菱椋諒令嶺玲倆凉寥撩楞燎聊鐐
りょく	力緑綠
りん	倫厘林臨輪隣鱗麟鈴凛珠梨淋燐琳吝悋淪稟綸醂霖
りんしょ	吝
りー	里
る	流留瑠昼路盧縷
るい	塁涙累類壘淚類
るを	雄郎郞
れ	玲礼禮余令連餘
れい	戻令例冷励玲礼鈴隷零霊麗齢勵禮靈黎齡戾伶嶺怜苓儷澪茘
れき	暦歴曆歷瀝礫轢
れっ	列劣烈裂
れつ	列劣烈裂律冽
ればやし	林
れん	廉恋憐煉簾練聯蓮連錬戀練鍊攣斂輦
ろ	幌呂炉賂路露浪郎論濾爐沪郞芦楽鷺二侶魯櫓婁朗篭老蝋禄枦梠樂盧籠絽艪蘆驢鹵蠟
ろう	糧露労廊弄朗楼浪漏牢篭老蝋郎勞樓籠郞朗廊蠟桜龍良狼聾壟撈朧櫻瓏瘻臘臈陋鵞
ろく	緑六麓禄録綠錄鹿陸肋碌勒
ろっ	六緑肋
ろひこ	州
ろみ	鏡
ろん	龍論乱亂崙
わ	羽我波琶盤訪輪和話割環慧沢匂杷破沸分湧葉倭鷲澤
わい	哀隈賄猥愛慧涌歪匯矮
わか	若稚別
わかし	沸
わが	我吾
わき	脇刀湧腋
わきの	脇
わぎ	吾脇
わく	涌惑枠飽湧
わけ	分訳譯脇
わこ	若
わさ	稙
わざ	技業
わざわ	災
わし	鷲
わしの	鷺
わす	忘
わず	僅
わずら	患煩
わせ	鷲
わた	幡綿渡亘
わたくし	私
わたし	私渡
わたな	渡
わたの	渡
わたら	度
わたり	渡
わだ	皮
わちが	輪
わっ	割輪和
わっか	稚
わに	鰐
わの	倭
わび	詫侘
わら	原春笑藁
わらの	原
わらび	蕨
わらべ	童
わり	割張破
わる	悪惡
われ	我吾
わん	湾碗腕灣雲王椀彎弯
